%%%%%%%%%%%%%%%%%%%%
%                  %
%     %            %
%     %            %
%     %        G   %
%     %%%%%%%%%%%%%%
%                  %
%                  %
%                  %
%                 P%
%        GGG       %
%                  %
%                  %
%%%%%%%%%%%%%%%%%%%%
% % % % %%%%%%%%%%%%
%%%%%%%%%%%%%%%%%%%%
